````````````````````````````````````````````````````````````````````````````````
````````````````````````````````````````````````````````````````````````````````
````````````````````````````````````````````````````````````````````````````````
````````````````````````````````````````````````````````````````````````````````
````````````````````````````````````````````````````````````````````````````````
````````````````````````````````````````````````````````````````````````````````
``````````````````````````````````````````````````````````````````````````````
``````````````````````````````````  ``````````````````````
`````````                        `````````````````````
```````                                           ``````````````````````
```````                           `````````````````````````
```````                                      `````````````````````````
```````                               ````````````````````````
```````                    `````````````````````````
``````                                         `````````````````
``````                                                      ````````````````
``````                  ``  `````````````````
``````                 `````````````````````````````````````````````````````
```````                 ``````````````````````````````````````````````````````
````````                ``````````````````````````````````````````````````````
````````                ``````````````````````````````````````````````````````
````````````````````````````````````````````````````````````````
````````````````````````````````````````````````````````````````````````````````
````````````````````````````````````````````````````````````````````````````````
