````````````````````````````````````````````````````````````````````````````````
````````````````````````````````````````````````````````````````````````````````
````````````````````````````````````````````````````````````````````````````````
````````````````````````````````````````````````````````````````````````````````
````````````````````````````````````````````````````````````````````````````````
````````````````````````````````````````````````````````````````````````````````
``````````````````````````````````````````````````````````````````````````````
```````````````````````````  ```````````````
``````````````````````````                                      ``````````````
```````````````````````````  ```````````````
````````````                                 `````````````````
```````````                                      ``````````````````
```````````                                         ```````````````````````
```````````          ```````````````
``````````                                                      ``````````````
``````````                                        ```````````````
```````````                                                  `````````````````
```````````                                     ``````````````````
```````````                               `````````````````````````````
`````````````````````````````````````````````````
````````````````````````````````````````````````````````````````````````````````
````````````````````````````````````````````````````````````````````````````````
````````````````````````````````````````````````````````````````````````````````
````````````````````````````````````````````````````````````````````````````````