................................................................................
................................................................................
................................................................................
................................................................................
................................................................................
................................................................................
.......................................##..........####.........................
......................................#  #.......##    #........................
..................................#####  ########     #.........................
.................................#                   #..........................
............######................###          ######...........................
...........#      #................#           #................................
..........#        ################            ######...........................
..........#                                          #..........................
..........#                                         ########....................
..........#                                                 #...................
...........#                             ###################....................
...........#                #############.......................................
...........#               #....................................................
...........#              #.....................................................
............##############......................................................
................................................................................
................................................................................
................................................................................
