``````````````````````````````````_____________`````````````````````````````````
`````````````````````````````````/             \````````````````````````````````
````````````````````````````````/   __     __   \```````````````````````````````
```````````````````````````````|   /  \   /  \   |``````````````````````````````
```````````````````````````````|   \__//_\\__/   |``````````````````````````````
````````````````````````````````\  \_________/  /```````````````````````````````
````````````````````````````````/   \\|||||//   \```````````````````````````````
```````````````````````````````_\_______________/_``````````````````````````````
``````````````````````````````/  \_____\ /_____/  \`````````````````````````````
`````````````````````````````/ |       | |       | \````````````````````````````
`````````````````````````````\ |       | |       | /````````````````````````````
``````````````````````````````\|_______|_|_______|/`````````````````````````````
````````````````````````````````````````
````````````````````                                    ````````````````````
````````````````````                                    ````````````````````
````````````````````                                    ````````````````````
````````````````````                                    ````````````````````
````````````````````                                    ````````````````````
````````````````````                                    ````````````````````
````````````````````                                    ````````````````````
````````````````````                                    ````````````````````
````````````````````                                    ````````````````````
````````````````````````````````````````
````````````````````````````````````````````````````````````````````````````````
