```_______________________ 
``/                       \
``|                       |
`/                        |
`\                        |
``|                       |
``|                       |
``\_______________________/