лллллллллллллллллллллллллллллллллллллллллллллллллллллллллллллллллллллллллллллллл
л                                                                              л
л                                                                              л
л                                                                              л
л                           PRESS    [W]    TO MOVE                            л
л                                 [A][S][D]                                    л
л                                                                              л
л                                                                              л
л                                                                              л
л                                                                              л
л                           PRESS    [^]    TO FIRE                            л
л                                 [<][v][>]                                    л
л                                                                              л
л                                                                              л
л                                                                              л
л                                                                              л
л                                                                              л
л                            PRESS [ESC] TO GO BACK                            л
л                                TO MAIN MENU                                  л
л                                                                              л
л                                                                              л
л                                                                              л
л                                                                              л
лллллллллллллллллллллллллллллллллллллллллллллллллллллллллллллллллллллллллллллллл
                                                                                