                                                                                
 ﾛﾛﾛﾛﾛﾛﾛﾛﾛﾛﾛﾛﾛﾛﾛﾛﾛﾛﾛﾛﾛﾛﾛﾛﾛﾛﾛﾛﾛﾛﾛﾛﾛﾛﾛﾛﾛﾛﾛﾛﾛﾛﾛﾛﾛﾛﾛﾛﾛﾛﾛﾛﾛﾛﾛﾛﾛﾛﾛﾛﾛﾛﾛﾛﾛﾛﾛﾛﾛﾛﾛﾛﾛﾛﾛﾛﾛﾛ 
 ﾛ                                                                            ﾛ 
 ﾛ                                    Pong                                    ﾛ 
 ﾛ                                 Rally Points                               ﾛ 
 ﾛ                                                                            ﾛ 
 ﾛ                                1.                                          ﾛ 
 ﾛ                                2.                                          ﾛ 
 ﾛ                                3.                                          ﾛ 
 ﾛ                                                                            ﾛ 
 ﾛ                                                                            ﾛ 
 ﾛ                                                                            ﾛ 
 ﾛ                                    Snake                                   ﾛ 
 ﾛ                                Length of body                              ﾛ 
 ﾛ                                                                            ﾛ 
 ﾛ                                1.                                          ﾛ 
 ﾛ                                2.                                          ﾛ 
 ﾛ                                3.                                          ﾛ 
 ﾛ                                                                            ﾛ 
 ﾛ                                                                            ﾛ 
 ﾛ                                                                            ﾛ 
 ﾛ                                                                            ﾛ 
 ﾛ                                                                            ﾛ 
 ﾛﾛﾛﾛﾛﾛﾛﾛﾛﾛﾛﾛﾛﾛﾛﾛﾛﾛﾛﾛﾛﾛﾛﾛﾛﾛﾛﾛﾛﾛﾛﾛﾛﾛﾛﾛﾛﾛﾛﾛﾛﾛﾛﾛﾛﾛﾛﾛﾛﾛﾛﾛﾛﾛﾛﾛﾛﾛﾛﾛﾛﾛﾛﾛﾛﾛﾛﾛﾛﾛﾛﾛﾛﾛﾛﾛﾛﾛ 
                                                                                