                                                                                
 лллллллллллллллллллллллллллллллллллллллллллллллллллллллллллллллллллллллллллллл 
 л                                                                            л 
 л                                    Pong                                    л 
 л                                                                            л 
 л                                                                            л 
 л                                1.                                          л 
 л                                2.                                          л 
 л                                3.                                          л 
 л                                                                            л 
 л                                                                            л 
 л                                                                            л 
 л                                                                            л 
 л                                                                            л 
 л                                                                            л 
 л                                                                            л 
 л                                                                            л 
 л                                                                            л 
 л                                                                            л 
 л                                                                            л 
 л                                                                            л 
 л                                                                            л 
 л                                                                            л 
 лллллллллллллллллллллллллллллллллллллллллллллллллллллллллллллллллллллллллллллл 
                                                                                