````````````````````````````````````````````````````````````````````````````````
````````````````````````````````````````````````````````````````````````````````
````````````````````````````````````````````````````````````````````````````````
````````````````````````````````````````````````````````````````````````````````
````````````````````````````````````````````````````````````````````````````````
````````````````````````````````````````````````````````````````````````````````
``````````````````````````````````````````````````````````````````````````````
```````````````  ````````````````````````````
``````      ``````                               ````````````````````
``````       ``````                             ```````````````````
``````        ```````````````  ````````````````````
``````           `````````````````````````````
``````                                            ````````````````````````````
``````                                   ````````````````````````````
`````                                 `````````````````````````````
`````                                 `````````````````
``````                                                        ````````````````
``````                                     `````````````````
``````                                      ````````````````````````````````
```````                        `````````````````````````````````
````````````````````````````````````````````````````````
````````````````````````````````````````````````````````````````````````````````
````````````````````````````````````````````````````````````````````````````````
````````````````````````````````````````````````````````````````````````````````
