````````````````````````````````````````````````````````````````````````````````
````````````````````````````````````````````````````````````````````````````````
````````````````````````````````````````````````````````````````````````````````
````````````````````````````````````````````````````````````````````````````````
````````````````````````````````````````````````````````````````````````````````
````````````````````````````````````````````````````````````````````````````````
``````````````````````````````````````````````````````````````````````````````
`````````````````  ``````````````````````
``````````                                         ````````````````````
````````      `                                  ```````````````````
````````       ``````                             ````````````````````
````````        ``````       ````````````````````````
````````         ```````````````````               `````````````````````````
````````                    ``````````````````````````
```````                                          `````````````````````````
```````                                               ````````````````````
````````                                                   ```````````````````
````````                         ````````````````````
````````                         `````````````````````````````````````````````
```````````````````````````````````````````````````````
````````````````````````````````````````````````````````````````````````````````
````````````````````````````````````````````````````````````````````````````````
````````````````````````````````````````````````````````````````````````````````
````````````````````````````````````````````````````````````````````````````````
