````````````````````````````````````````````````````````````````````````````````
````````````````````````````````````````````````````````````````````````````````
````````````````````````````````````````````````````````````````````````````````
````````````````````````````````````````````````````````````````````````````````
````````````````````````````````````````````````````````````````````````````````
````````````````````````````````````````````````````````````````````````````````
``````````````````````````````````````````````````````````````````````````````
`````````````````````````  ````````````````
`````````      `````````````                                 ```````````````
`````````       `````````````  ````````````````
`````````          ````````````````````````````````
`````````                                      ``````````````````````````
````````                               ````````````````````
````````                                                   ```````````````````
````````                                       ````````````````````
````````                                             `````````````````````````
`````````                                    `````````````````````
`````````                 ````               ``     ````````````````````
`````````                ````                `      `````````````````````
``````````````                        ``````````````````````
`````````````````````````````                          ```````````````````````
``````````````````````````````````````````````````````
````````````````````````````````````````````````````````````````````````````````
````````````````````````````````````````````````````````````````````````````````
