````````````````````````````````````````````````````````````````````````````````
 лллллллллллллллллллллллллллллллллллллллллллллллллллллллллллллллллллллллллллллл 
 л                                                                            л 
 л                                 Minigames                                  л 
 л                                                                            л 
 л                                                                            л 
 л                                                                            л 
 л                                                                            л 
 л                                                                            л 
 л                                                                            л 
 л                                                                            л 
 л                                                                            л 
 л                                                                            л 
 л                                                                            л 
 л                                                                            л 
 л                                                                            л 
 л                                                                            л 
 л                                                                            л 
 л                                                                            л 
 л                                                                            л 
 л                                                                            л 
 л                                                                            л 
 л                                                                            л 
 лллллллллллллллллллллллллллллллллллллллллллллллллллллллллллллллллллллллллллллл 
                                                                                