````````````````````````````````````````````````````````````````````````````````
````````````````````````````````````````````````````````````````````````````````
````````````````````````````````````````````````````````````````````````````````
лллллллллллллллллллллллллллллллллллллллллллллллллллллллллллллллллллллллллллллллл
лл                                      |                                     лл
лл                                      |                                     лл
лл                                      |                                     лл
лл                                      |                                     лл
лл                                      |                                     лл
лл                                      |                                     лл
лл                                      |                                     лл
лл                                      |                                     лл
лл                                      |                                     лл
лл                                      |                                     лл
лл                                      |                                     лл
лл                                      |                                     лл
лл                                      |                                     лл
лл                                      |                                     лл
лл                                      |                                     лл
лл                                      |                                     лл
лл                                      |                                     лл
лл                                      |                                     лл
лл                                      |                                     лл
лллллллллллллллллллллллллллллллллллллллллллллллллллллллллллллллллллллллллллллллл
                                                                                
