````````````````````````````````````````````````````````````````````````````````
````````````````````````````````````````````````````````````````````````````````
````````````````````````````````````````````````````````````````````````````````
````````````````````````````````````````````````````````````````````````````````
````````````````````````````````````````````````````````````````````````````````
````````````````````````````````````````````````````````````````````````````````
````````````````````````````````````````````````````````````````````````````````
````````````````````````````````````````````````````````````````````````````````
````````````````````````````````````````````````````````````````````````````````
````````````````````````````````````````````````````````````````````````````````
````````````````````````````````````````````````````````````````````````````````
ﾛﾛﾛﾛﾛﾛﾛﾛﾛﾛﾛﾛﾛﾛﾛﾛﾛﾛﾛﾛﾛﾛﾛﾛﾛﾛﾛﾛﾛﾛﾛﾛﾛﾛﾛﾛﾛﾛﾛﾛﾛﾛﾛﾛﾛﾛﾛﾛﾛﾛﾛﾛﾛﾛﾛﾛﾛﾛﾛﾛﾛﾛﾛﾛﾛﾛﾛﾛﾛﾛﾛﾛﾛﾛﾛﾛﾛﾛﾛﾛ
ﾛﾛ                                   |     |                                  ﾛﾛ
ﾛﾛ                                   |     |                                  ﾛﾛ
ﾛﾛ                                   |     |                                  ﾛﾛ
ﾛﾛﾛﾛﾛﾛﾛﾛﾛﾛﾛﾛﾛﾛﾛﾛﾛﾛﾛﾛﾛﾛﾛﾛﾛﾛﾛﾛﾛﾛﾛﾛﾛﾛﾛﾛﾛﾛﾛﾛﾛﾛﾛﾛﾛﾛﾛﾛﾛﾛﾛﾛﾛﾛﾛﾛﾛﾛﾛﾛﾛﾛﾛﾛﾛﾛﾛﾛﾛﾛﾛﾛﾛﾛﾛﾛﾛﾛﾛﾛ
````````````````````````````````````````````````````````````````````````````````
````````````````````````````````````````````````````````````````````````````````
````````````````````````````````````````````````````````````````````````````````
````````````````````````````````````````````````````````````````````````````````
````````````````````````````````````````````````````````````````````````````````
````````````````````````````````````````````````````````````````````````````````
````````````````````````````````````````````````````````````````````````````````
````````````````````````````````````````````````````````````````````````````````                           