````````````````````````````````````````````````````````````````````````````````
````````````````````````````````````````````````````````````````````````````````
````````````````````````````````````````````````````````````````````````````````
````````````````````````````````````````````````````````````````````````````````
````````````````````````````````````````````````````````````````````````````````
````````````````````````````````````````````````````````````````````````````
``````````````````````````````````````````````````    `````````````````````
```````````````````````````````       ``````````````````````
````````````````                         ```````````````````
`````````                                             ``````````````````
``````      ``                                  ```````````````````
``````                                 ```````````````````````````
`````                                            ````````````````````````````
`````                                            `````````````````````````````
`````                   ````````````````
``````                                                ```````````````
``````                                                ````````````````
``````             `````````````````````````
```````````````````````````````````````````````````````````````````
````````````````````````````````````````````````````````````````````````````````
````````````````````````````````````````````````````````````````````````````````
````````````````````````````````````````````````````````````````````````````````
````````````````````````````````````````````````````````````````````````````````
````````````````````````````````````````````````````````````````````````````````
