````
````
````
````
``                                                                          ``
``                                                                          ``
``                                                                          ``
``                                                                          ``
``                                                                          ``
``                                                                          ``
``                                                                          ``
``                                                                          ``
``                                                                          ``
``                                                                          ``
``                                                                          ``
``                                                                          ``
``             +---------------------------------------------+              ``
``             |                                             |              ``
``             |                                             |              ``
``             |                                             |              ``
``             +---------------------------------------------+              ``
``                                                                          ``
````
````````````````````````````````````````````````````````````````````````````````