````
````
````
````
``                                                                          ``
``                              _            _                              ``
``                            / \__________/ \                              ``
``                          _/             __|_                             ``
``                         / |   _/\_     /   \\                            ``
``                        |  | _/    \_   |    \|      _                    ``
``                        |  |/| O . O \  |     |     / |                   ``
``                         \_| |  \_/  |  |____/___  / /                    ``
``                           | \_______| |         \/ /                     ``
``                           \/|  _    \/_____      _/                      ``
``                             |  ||  |  \__ \___  |                        ``
``                              \/  \/      \/   \/                         ``
``             +---------------------------------------------+              ``
``             |                                             |              ``
``             |                                             |              ``
``             |                                             |              ``
``             +---------------------------------------------+              ``
``                                                                          ``
````
````````````````````````````````````````````````````````````````````````````````