                                                                                
                                                                                
                                                                                
ÛÛÛÛÛÛÛÛÛÛÛÛÛÛÛÛÛÛÛÛÛÛÛÛÛÛÛÛÛÛÛÛÛÛÛÛÛÛÛÛÛÛÛÛÛÛÛÛÛÛÛÛÛÛÛÛÛÛÛÛÛÛÛÛÛÛÛÛÛÛÛÛÛÛÛÛÛÛÛÛ
Û                                                                              Û
Û                                                                              Û
Û                               Tic Tac Toe Game                               Û
Û                                                                              Û
Û                                   |      |                                   Û
Û                                   |      |                                   Û
Û                             ______|______|______                             Û
Û                                   |      |                                   Û
Û                                   |      |                                   Û
Û                             ______|______|______                             Û
Û                                   |      |                                   Û
Û                                   |      |                                   Û
Û                                   |      |                                   Û
Û                                                                              Û
Û                            You have the 'O' symbol                           Û
Û                          Computer has the 'X' symbol                         Û
Û                                                                              Û
Û                                                                              Û
Û                                                                              Û
ÛÛÛÛÛÛÛÛÛÛÛÛÛÛÛÛÛÛÛÛÛÛÛÛÛÛÛÛÛÛÛÛÛÛÛÛÛÛÛÛÛÛÛÛÛÛÛÛÛÛÛÛÛÛÛÛÛÛÛÛÛÛÛÛÛÛÛÛÛÛÛÛÛÛÛÛÛÛÛÛ

