                                                                                
                                                                                
                                                                                
лллллллллллллллллллллллллллллллллллллллллллллллллллллллллллллллллллллллллллллллл
л                                                                              л
л                                                                              л
л                               Tic Tac Toe Game                               л
л                                                                              л
л                                   |      |                                   л
л                                   |      |                                   л
л                             ______|______|______                             л
л                                   |      |                                   л
л                                   |      |                                   л
л                             ______|______|______                             л
л                                   |      |                                   л
л                                   |      |                                   л
л                                   |      |                                   л
л                                                                              л
л                          Player 1 has the 'O' symbol                         л
л                          Player 2 has the 'X' symbol                         л
л                                                                              л
л    Player                                                                    л
л                                                                              л
лллллллллллллллллллллллллллллллллллллллллллллллллллллллллллллллллллллллллллллллл